KBFI    10915    KCLM    11016
KBFI    11230    KCLM    11329
KBFI    11400    KCLM    11459
KBFI    12000    KCLM    12101
KBFI    11115    KPAE    11137
KBFI    11330    KPAE    11352
KBFI    11930    KPAE    11952
KBFI    12130    KPAE    12152
KBLI    10830    KFHR    10855
KBLI    11415    KFHR    11440
KBLI    10800    KPAE    10854
KBLI    11200    KPAE    11254
KBLI    11600    KPAE    11654
KBLI    10815    KPWT    10933
KBLI    11145    KPWT    11303
KBLI    11300    KPWT    11418
KBLI    11620    KPWT    11738
KBLI    11910    KPWT    12028
KCLM    11800    KPAE    11850
KCLM    10700    KBFI    10759
KCLM    11040    KBFI    11139
KCLM    11517    KBFI    11616
KCLM    12130    KBFI    12229
KCLM    11645    KCLM    11715
KCLM    10800    KFHR    10830
KCLM    11315    KFHR    11345
KCLM    11130    KPAE    11220
KCLM    11530    KPAE    11220
KCLM    11202    KPWT    11250
KCLM    11630    KPWT    11718
KFHR    11045    KBLI    11110
KFHR    11410    KBLI    11435
KFHR    10845    KCLM    10915
KFHR    11120    KCLM    11150
KFHR    11840    KCLM    11910
KPAE    10930    KBFI    10952
KPAE    11200    KBFI    11222
KPAE    11420    KBFI    11442
KPAE    11615    KBFI    11637
KPAE    11000    KBLI    11054
KPAE    11300    KBLI    11354
KPAE    11700    KBLI    11754
KPAE    10915    KCLM    11005
KPAE    11340    KCLM    11430
KPAE    11750    KCLM    11840
KPWT    11000    KBLI    11118
KPWT    11430    KBLI    11548
KPWT    11840    KBLI    11958
KPWT    11100    KCLM    11148
KPWT    11540    KPWT    11628